NO ./path_to_the_north_texture
SO ./path_to_the_south_texture
WE ./path_to_the_west_texture
EA ./path_to_the_east_texture
F 50,117,45
C 30,90,177



  111111111111111111111
11100000000000000000001
10111111111111111000001
10000000000000001001111
10001100000000001001
10001000000000100001
10001110000000001001
10000000000000001001
10000000000001000001
10000000000000000001
11111111111111111111